0,1,1,1,1,1,1,1,0
1,3,6,3,6,3,5,5,1
1,5,6,4,5,4,3,6,1
1,6,4,3,3,5,6,5,1
1,5,5,3,4,3,5,4,1
1,6,4,4,5,4,4,6,1
1,4,5,6,4,5,4,5,1
1,4,4,6,3,6,5,5,1
0,1,1,1,1,1,1,1,0
