0,1,1,1,1,1,1,1,0
1,r,p,r,p,r,y,y,1
1,y,p,g,y,g,r,p,1
1,p,g,r,r,y,p,y,1
1,y,y,r,g,r,y,g,1
1,p,g,g,y,g,g,p,1
1,g,y,p,g,y,g,y,1
1,g,g,p,r,p,y,y,1
0,1,1,1,1,1,1,1,0
